SO textures/blue_stone.xpm
WE textures/wall_3.xpm
EA textures/wall_4.xpm
NO textures/wall_1.xpm

F  255,10,2

C 1,0,1






        1111111111111111111111111
        1000000001100000010000011
        1011000001110000000100001
       111001000000000000001000001  11111111
111111110110000011100000000000001111000001
100000000011000001110111111111111   11111111
11110111111111011100000010001
1111011111111101110101001S01
111111111111111111111111111111
111111111111111111111111111111
110011001101010111000000100011
1001 1000000000000110000001000111
100111000000000011010100100001
110000011101010111110111100111
11110111  1110101 10111101001 
11111111 1111111 111111111111
