   WE                            textures/wolfenstein/grey_stone.xpm
NO      textures/wolfenstein/purple_stone.xpm



SO textures/wolfenstein/red_brick.xpm

F      17,    38,     64

EA textures/wolfenstein/wood.xpm



C 218, 234, 235

1111111111111111111111111
10S0110000100000000000001
111111000000000011111100111111
     1000110000000000110001001
111111000010000000000100111111
1111111111111111111111111
11111
10001
11111
